21 21 21 21 21 21 21 21 21 21 21 21 21 21 21 21 21 21 22 22 22 21 21 21 21 21 22 21 21 22 21 22 22 21 21 21 21 21 21 21 22 21 21 21 21 22 21 22 21 21 
21 21 21 21 21 21 21 21 21 21 21 21 21 21 21 21 21 21 21 22 21 22 22 22 21 22 22 21 21 22 21 21 21 21 21 21 22 22 21 21 21 21 21 22 21 21 22 21 21 21 
22 22 31 29 29 29 29 29 29 29 29 29 29 29 29 29 29 29 29 29 29 29 29 29 29 29 29 29 29 29 29 29 29 29 29 29 29 29 29 29 29 29 29 29 29 29 29 32 22 21 
22 22 27 19 19 19 19 19 19 19 19 19 19 19 19 19 19 19 19 19 19 19 19 19 19 19 19 19 19 19 19 19 19 19 19 19 19 19 19 19 19 19 19 19 19 19 19 26 22 21 
21 22 27 19 19 19 19 19 19 19 19 2 2 19 19 19 19 19 19 19 19 19 19 19 19 19 19 19 19 19 19 19 19 19 19 19 19 19 19 19 19 19 19 19 19 19 19 26 21 21 
21 21 27 19 19 19 19 2 2 2 3 2 2 3 2 2 2 2 2 2 2 2 2 2 2 2 2 19 19 2 2 2 2 2 2 2 3 2 2 2 2 3 2 2 2 19 19 26 21 21 
21 21 27 19 19 19 19 2 2 2 2 2 2 2 2 2 2 2 2 2 19 19 19 2 2 2 2 19 19 19 2 2 2 2 19 2 2 2 3 2 2 2 2 19 2 19 19 26 22 21 
22 22 27 19 19 2 19 19 2 23 24 24 24 24 25 2 2 19 19 19 19 19 19 19 2 2 2 19 2 2 3 2 2 19 19 2 2 2 2 2 19 2 2 19 19 19 19 26 22 21 
22 21 27 19 19 2 2 19 2 26 21 22 21 22 27 2 2 19 19 2 2 19 2 2 2 3 2 2 2 3 3 2 2 2 2 2 2 2 2 2 19 2 2 2 19 19 19 26 21 21 
22 21 27 19 19 3 2 19 2 26 21 21 22 21 27 2 3 3 19 2 2 2 2 2 2 2 3 2 2 2 2 2 2 2 2 3 3 2 2 19 19 2 2 19 19 19 19 26 21 22 
22 21 27 19 19 2 3 19 19 26 21 22 21 21 27 2 3 2 3 19 19 19 19 19 2 3 2 19 19 19 19 19 19 19 2 2 2 2 2 19 19 2 2 2 19 19 19 26 21 22 
22 21 27 19 19 2 2 19 19 28 29 29 29 29 30 2 2 2 2 19 19 19 19 19 2 2 2 19 19 19 19 19 19 19 19 2 19 2 2 19 19 2 19 19 19 19 19 26 21 22 
21 21 27 19 19 3 2 2 2 2 2 2 2 2 2 2 2 2 2 19 19 19 19 19 14 12 15 19 19 19 19 19 19 19 19 19 19 2 2 2 2 2 2 2 2 19 19 26 21 21 
21 21 27 19 19 2 2 2 2 19 19 19 2 3 2 19 19 19 19 19 19 19 19 19 10 5 9 19 19 19 19 19 19 19 19 19 19 19 19 2 2 3 2 2 2 19 19 26 22 21 
21 22 27 19 19 19 19 3 2 3 2 19 2 2 2 3 19 19 19 19 19 19 19 19 10 5 9 19 19 19 19 19 19 19 19 19 19 19 19 19 2 2 2 3 2 19 19 26 22 21 
21 21 27 19 19 19 19 19 2 2 2 3 2 2 2 2 2 2 2 19 19 19 19 19 10 5 9 19 19 19 19 19 19 19 19 19 19 19 19 19 19 19 19 2 3 19 19 26 21 22 
21 21 27 19 19 19 19 19 19 19 19 19 19 19 19 19 19 19 19 19 19 19 19 19 10 5 9 19 19 19 19 19 19 19 19 19 19 19 19 19 19 19 19 19 19 19 19 26 22 22 
22 21 27 19 19 19 19 19 19 19 19 19 19 19 19 19 19 19 19 19 19 19 19 19 10 5 9 19 19 19 19 19 19 19 19 19 19 19 19 19 19 19 19 19 19 19 19 26 22 22 
22 21 27 19 19 2 2 2 2 19 2 2 19 19 19 19 19 19 19 19 19 19 19 19 10 5 9 19 19 19 19 19 19 19 19 19 2 2 2 3 2 19 19 19 19 19 19 26 22 21 
21 21 27 19 19 2 2 2 2 19 2 2 19 19 19 19 19 19 19 19 19 19 19 19 10 5 9 19 19 19 19 19 19 19 19 19 2 2 2 2 2 2 2 2 19 19 19 28 29 29 
21 21 27 19 19 2 2 2 2 19 2 2 19 19 19 19 19 19 19 19 19 19 19 19 10 5 9 19 19 19 19 19 19 19 19 19 2 3 2 2 3 2 2 2 2 2 19 19 19 19 
21 21 27 19 19 2 19 19 2 2 2 2 19 19 19 19 19 19 19 19 19 19 19 19 10 5 9 19 19 19 19 19 19 19 19 2 19 2 2 2 2 2 2 2 2 2 2 2 2 19 
21 21 27 19 19 2 19 19 19 2 2 2 19 19 19 19 19 19 19 19 19 19 2 3 10 5 9 2 2 3 2 19 19 19 2 19 19 19 19 2 2 2 2 2 2 19 19 19 2 19 
21 21 27 19 19 2 2 19 19 19 19 19 19 3 2 19 2 3 2 2 19 19 2 3 10 5 9 3 2 2 2 19 19 2 2 2 19 19 2 2 3 2 2 19 19 19 2 19 2 19 
22 21 27 19 19 2 2 2 2 2 2 19 19 14 12 12 12 12 12 12 12 12 12 12 13 5 11 12 12 12 12 12 12 12 12 12 12 12 12 12 15 2 2 19 2 2 2 19 2 19 
21 21 27 19 19 2 2 3 2 2 2 2 2 10 5 5 5 5 5 5 5 5 5 5 5 5 5 5 5 5 5 5 5 5 5 5 5 5 5 5 9 19 19 19 2 3 2 19 2 19 
21 21 27 19 19 2 2 2 2 3 2 19 19 16 7 7 7 7 7 7 7 7 7 7 8 5 6 7 7 7 7 7 7 7 7 7 7 7 7 7 17 19 2 2 2 2 2 19 2 19 
22 21 27 19 19 2 2 3 2 3 2 19 19 2 3 2 2 19 19 19 2 3 2 2 10 5 9 2 3 2 19 19 2 19 2 2 19 19 19 19 19 19 2 2 3 19 19 19 2 19 
22 21 27 19 19 2 2 2 2 3 2 2 19 19 19 19 19 19 19 19 19 19 19 3 10 5 9 3 2 19 19 19 19 19 19 19 19 19 19 19 19 19 2 19 19 19 19 19 2 19 
21 21 27 19 19 2 2 3 2 2 2 2 19 19 19 19 19 19 19 19 19 19 19 19 10 5 9 19 19 19 19 19 19 19 19 19 19 19 19 19 19 2 2 19 19 2 2 2 2 19 
21 21 27 19 19 2 3 2 2 2 2 2 19 19 19 19 19 19 19 19 19 19 19 19 10 5 9 19 19 19 19 2 2 2 2 2 2 19 19 19 2 2 2 2 2 2 19 19 19 19 
21 21 27 19 19 2 19 19 19 19 19 19 19 19 19 19 19 19 19 19 19 19 19 19 10 5 9 19 19 19 2 2 3 2 2 3 2 19 19 19 19 2 19 2 3 3 19 19 19 19 
21 22 27 19 19 2 19 19 19 19 19 19 19 19 19 19 19 19 19 19 19 19 19 19 10 5 9 19 2 2 2 2 2 2 2 2 2 19 19 19 19 19 19 19 19 19 19 23 24 24 
22 21 27 19 19 2 2 2 2 2 2 19 19 19 19 19 19 19 19 19 19 19 19 19 16 7 17 19 2 2 2 3 2 2 2 2 2 2 2 2 19 2 2 2 19 19 19 26 21 21 
21 21 27 19 19 2 2 2 2 2 2 19 19 19 2 19 19 19 19 2 2 2 2 19 19 2 19 19 2 3 2 19 19 19 19 19 19 19 19 2 19 2 19 2 19 19 19 26 22 21 
22 21 27 19 19 2 2 2 2 2 2 19 19 19 2 19 19 19 19 2 19 19 2 19 19 2 19 19 2 2 2 19 19 19 19 19 19 19 19 2 2 2 19 2 2 2 2 26 21 22 
22 21 27 19 19 2 3 2 2 2 19 2 2 2 19 19 19 2 2 2 19 19 2 19 19 2 19 19 2 19 19 19 2 2 2 2 2 20 20 20 20 20 20 20 20 19 2 26 21 21 
21 21 27 19 19 2 2 3 3 19 19 2 2 2 19 19 19 2 19 19 19 19 2 2 2 2 19 19 2 2 2 19 2 3 2 2 2 20 1 1 1 1 1 1 20 19 2 26 22 21 
22 22 27 19 19 2 2 2 19 19 19 2 2 2 19 19 2 2 19 19 19 19 19 19 19 19 19 19 19 19 2 19 2 2 2 2 2 20 1 1 1 1 1 1 20 19 2 26 21 21 
21 21 27 19 19 2 2 2 19 2 2 3 2 2 19 19 2 19 19 19 19 19 19 19 19 19 19 19 2 2 2 19 2 3 2 3 2 2 1 1 1 1 1 1 20 19 2 26 21 22 
21 21 27 19 19 2 2 19 19 2 2 3 2 19 19 19 2 19 19 2 2 2 19 19 19 19 19 19 2 19 19 19 2 2 2 3 2 20 1 1 1 1 1 1 20 19 2 26 21 21 
22 21 27 19 19 2 19 19 2 2 2 2 19 19 19 2 2 19 2 2 19 2 19 19 2 2 2 19 2 19 19 19 2 2 2 2 2 20 1 1 1 1 1 1 20 19 2 26 21 21 
22 21 27 19 19 2 19 2 2 2 2 19 19 2 2 2 19 19 2 19 19 2 19 19 2 19 2 19 2 2 2 19 19 2 19 19 19 20 20 20 20 20 20 20 20 19 2 26 21 21 
21 21 27 19 19 2 2 2 2 19 19 19 2 2 2 2 19 2 2 19 2 2 19 2 2 19 2 19 19 19 2 19 19 2 19 19 19 19 2 2 2 2 19 19 19 19 2 26 22 21 
22 21 27 19 19 19 19 19 19 19 19 19 2 3 2 2 19 2 19 19 2 19 19 2 19 19 2 19 2 2 2 19 19 2 2 2 2 19 2 19 19 2 19 19 2 2 2 26 21 22 
22 22 27 19 19 19 19 19 19 19 19 19 2 2 2 2 19 2 19 19 2 2 2 2 19 19 2 2 2 19 19 19 19 19 19 19 2 2 2 19 19 2 2 19 2 19 19 26 21 22 
21 22 27 19 19 19 19 19 19 19 19 19 2 2 2 3 19 2 19 19 19 19 19 19 19 19 19 19 19 19 19 19 19 19 19 19 19 19 19 19 19 19 2 2 2 19 19 26 21 21 
21 21 33 24 24 24 24 24 24 24 24 25 2 3 2 2 2 2 19 19 23 24 24 24 24 24 24 24 24 24 24 24 24 24 24 24 24 24 24 24 24 24 24 24 24 24 24 34 21 21 
21 21 21 21 21 21 21 21 21 21 21 27 2 2 3 2 2 2 19 19 26 21 21 22 22 21 21 21 21 21 22 21 21 21 21 21 21 21 22 22 21 21 21 21 21 22 21 21 21 22 
21 21 22 21 21 21 21 22 22 21 21 33 24 24 24 24 24 24 24 24 34 21 21 22 21 21 21 22 22 21 22 21 21 21 22 22 21 21 22 21 21 21 21 21 22 21 22 21 21 21 
